#############
#...#...#...#
#.....m.....#
#...#...#...#
##.###.###.##
#...#...#...#
#...........#
#...#...#...#
##.###.###.##
#...#...#.c.#
#...........#
#...#...#.].#
#############