############
#c.#.......#
#...#..#...#
#....#.....#
##.........#
#......#...#
#.#........#
#....#.....#
##.........#
#m........##
#.....#....#
############