############
#c.#.m.....#
#...#..#...#
#....#..m..#
##.........#
#......#...#
#.#........#
#....#.....#
##......m..#
#m......].##
#.....#....#
############