############
#c.#.m.....#
#...#..#...#
#....#..m..#
##.........#
#......#...#
#.#.....d..#
#....#.....#
##......m..#
#m......].##
#.....#...d#
############