#####################
#c.............#]#..#
#..#................#
#.#.....##.##.......#
#.....##....##......#
#....#........#.....#
#....#........#.....#
#....#....m...#.....#
#....#........#.....#
#.....##....##......#
#.......##.##.#.....#
#..............#....#
#..###.###.###.###..#
#.........m.........#
#####################