#######################################
####...............................####
#c...................................d#
####...........#.......#...........####
#...............##...##...............#
#.................###.................#
#..........##.##.#####.##.##..........#
#......#.##.......###.......##.#......#
#....##....#.##...###...##.#....##....#
#.......##......#######......##.......#
#.....##....##..#######..##....##.....#
#.........##......###......##.........#
#........##....##.....##....##........#
#.....##....##...........##....##.....#
#....##.....##...........##.....##....#
#...........##...........##...........#
#..........##.............##..........#
####...............................####
#d..................................].#
####...............................####
#######################################